ppppp.....
pppp......
ppp.......
.........p
.........p
..........
..........
..........
..........
..........
